BuK
An Interactive Fiction by Noah Pivnick
Release 0 / Serial number 191017 / Inform 7 build 6M62 (I6/v6.33 lib 6/12N) SD

Driveway
It's night. You've arrived at the cabin after a grueling drive through a heavy winter storm. You are standing in the driveway up to your knees in heavy wet snow. Beside you is a battered station wagon casting dim incandescent light from a single headlight onto a cabin perched on square posts driven like pilings into the ground. You are exhausted and terribly thirsty but there's a lot to do before you can open the house and turn on the water. It's well below freezing and inside the cabin will be just as cold. You'll want to get a fire started as soon as possible.

You can see snow and a station wagon (closed) here.

>carry eli
Taken.

* * *

>carry fred
Taken.

>carry eli
Taken.

* * *

>eat snow
(first taking Snow)
You eat Snow. Not bad.

>look
Driveway
You've arrived at the cabin after a grueling winter drive through a heavy winter storm. The snow is up to your knees and you are standing beside a battered station wagon. The station wagon's headlights are on casting their incandesent light onto a cabin floating above ground on posts driven deep into the ground.

You can see a Station Wagon (in which are a set of keys, Romulus, Remus and Eli) here.

* * *

>enter car
You can't see any such thing.

>enter vehicle
You can't see any such thing.

>x wagon
A late 80"s Volvo station wagon that's seen better days. A section of thick, translucent, plastic drop cloth has been maticulously gaffer taped to the back gate where the rear window would normally be. The front of car on the passenger side is pretty well bashed up and only one headlight appears to be working. There's steam rising from underneath the crumpled hood.

In the Station Wagon are a set of keys, Romulus, Remus and a little boy.

>get in wagon
You get into the Station Wagon.

In the Station Wagon you can see a set of keys, Romulus, Remus and a little boy.

* * *

>enter station
You can't get into the closed Station Wagon.

>open wagon
You open the Station Wagon, revealing a set of keys, Romulus, Remus and a little boy.

>enter wagon
You get into the Station Wagon.

In the Station Wagon you can see a set of keys, Romulus, Remus and a little boy.

>x remus
A big dog. Half Belgian Shepard, half Newfoundland, and black as night. Romulus and Remus came from the same litter.

>x romulus
A big dog. Half Belgian Shepard, half Newfoundland, and black as night. Romulus and Remus came from the same litter.

>x keys
You see nothing special about the set of keys.

>x boy
The little boy is asleep in the back seat. His name is Eli. He's almost seven years old and he's wearing a secondhand snowsuit that's few sizes too big for him. Eli is not your child but you are his mom. It's complicated.

>up
(first getting out of the Station Wagon)

Front Stairs
The Front Stairs are made from lengths of 2 x 12 inch planks of unfinished wood. A foot of snow has accumulated on each step. You know from experience there might very well be a slick of ice beneath the snow. Best to shift Eli's little body over your shoulder in a fireman's carry so you can hold onto the railing with one hand.

>take keys
You can't see any such thing.

>purloin keys
[Purloined.]

>up
Front Deck
The Front Deck is nearly eight feet off the ground. There is no railing. A child could get hurt if they went off the deck from this height.

You can see a Front Door here.

>up
You can't go that way.

>unlock door with keys
You unlock the Front Door.

>open door
You open the Front Door.

>n
It's best to get Eli.

>n
It's best to get Eli.

>purloin eli
[Purloined.]

>n
Front Hall
Most of the cabin interior is built with sugar maple, including the floor. Sugar Maple is a hardwood indigenous to the area, which makes it affordable.

You can see a Front Door here.

>n
Living Room
You can see a Wood Burning Stove (closed) and firewood here.

>s
Front Hall
Most of the cabin interior is built with sugar maple, including the floor. Sugar Maple is a hardwood indigenous to the area, which makes it affordable.

You can see a Front Door here.

>u
You can't go that way.

>u
You can't go that way.

>up
You can't go that way.

* * *

>enter station wagon
You get into the Station Wagon.

In the Station Wagon you can see a set of keys, Romulus, Remus and Eli.

>take eli
Taken.

>exit station wagon
You get off the Station Wagon.

Driveway
You can see a Station Wagon (in which are a set of keys, Romulus and Remus) here.

>up driveway
I only understood you as far as wanting to (go) up.

>up
Front Stairs

>up
Front Deck
You can see a Front Door here.

>up
You can't go that way.

>open door
It seems to be locked.

>unlock front door
(with Eli)
That doesn't seem to fit the lock.

>down
Front Stairs

>down
Driveway
You can see a Station Wagon (in which are a set of keys, Romulus and Remus) here.

>enter station wagon
You get into the Station Wagon.

In the Station Wagon you can see a set of keys, Romulus and Remus.

>take keys
Taken.

>exit
You get out of the Station Wagon.

Driveway
You can see a Station Wagon (in which are Romulus and Remus) here.

>up
Front Stairs

* * *

>up
Front Deck
You can see a Front Door here.

>open door
It seems to be locked.

>unlock door
What do you want to unlock the Front Door with?

>unlock door with keys
You unlock the Front Door.

>enter
You must supply a noun.

>n
(first opening the Front Door)

Front Hall
You can see a Front Door here.

* * *

>enter the station wagon
You get into the Station Wagon.

In the Station Wagon you can see Romulus, Remus and Eli.

>x eli
You see nothing special about Eli.

>up
Front Stairs (in the Station Wagon)
In the Station Wagon you can see Romulus, Remus and Eli.

>take eli
Taken.

>exit station wagon
I only understood you as far as wanting to exit.

>leave station wagon
I only understood you as far as wanting to leave.

* * *

>enter the wagon
You get into the Station Wagon.

In the Station Wagon you can see a set of keys, Romulus, Remus and a little boy.

>get into the wagon
But you're already in the Station Wagon.

>get out of the wagon
You get off the Station Wagon.

Driveway
You've arrived at the cabin after a grueling winter drive through a heavy winter storm. You are standing beside a station wagon and the snow is up to your knees.

You can see a Station Wagon (in which are a set of keys, Romulus, Remus and Eli) here.

>look
Driveway
You've arrived at the cabin after a grueling winter drive through a heavy winter storm. You are standing beside a station wagon and the snow is up to your knees.

You can see a Station Wagon (in which are a set of keys, Romulus, Remus and Eli) here.

* * *

>enter the wagon
You get into the Station Wagon.

In the Station Wagon you can see a set of keys, Romulus, Remus and a little boy.

>look
Driveway (in the Station Wagon)
You've arrived at the cabin after a grueling winter drive through a heavy winter storm. You are standing in the driveway up to your knees in deep, heavy wet snow. Beside you is a battered station wagon casting dim incandesent light from a single headlight onto a cabin floating above ground on square posts that have been driven deep into the earth. You are tired and terribly thirsty from the drive but there's a lot to do before you can open the house and turn on the water. It's well below freezing and the cabin will be very cold. You'll want to get a fire started as soon as possible.

You can see Snow here.

In the Station Wagon you can see a set of keys, Romulus, Remus and a little boy.

>enter the wagon
But you're already in the Station Wagon.

>i
You are carrying nothing.

>reset
That's not a verb I recognise.

>restart
Are you sure you want to restart?

>y
Cabin in The Woods
An Interactive Fiction by Noah Pivnick
Release 1 / Serial number 191015 / Inform 7 build 6M62 (I6/v6.33 lib 6/12N) SD

Driveway
You've arrived at the cabin after a grueling winter drive through a heavy winter storm. You are standing in the driveway up to your knees in deep, heavy wet snow. Beside you is a battered station wagon casting dim incandesent light from a single headlight onto a cabin floating above ground on square posts that have been driven deep into the earth. You are tired and terribly thirsty from the drive but there's a lot to do before you can open the house and turn on the water. It's well below freezing and the cabin will be very cold. You'll want to get a fire started as soon as possible.

You can see Snow and a Station Wagon (in which are a set of keys, Romulus, Remus and a little boy) here.

>eat snow
(first taking Snow)
You eat Snow. Not bad.

>take keys
Taken.

>put keys in station wagon
You put the set of keys into the Station Wagon.

>up
Front Stairs
The Front Deck is nearly eight feet off the ground, accessible by a rise of ten steps made from 2x12 inch boards of weathered pressure treated wood. A foot of snow has accumulated on each step. You know from experience there might very well be a slick of ice beneach the snow. Best to shift Eli's little body over your shoulder in a fireman's carry so you can hold onto the railing with one hand.

>up
Front Deck
You can see a Front Door here.

>open
(the Front Door)
It seems to be locked.

>x door
The Front Door is heavy and slides to one side like a barn door. This was a financial decision. Regular doors on hinges are expensive and need to be hung properly. The door has a large window but the window is boarded up from the inside with a piece of plywood.

>open the door
It seems to be locked.

>unlock the door
(with the Front Door)
(first taking the Front Door)
That's fixed in place.

>unlock the lock
You can't see any such thing.

>purloin the keys
[Purloined.]

>unlock the door
(with the set of keys)
You unlock the Front Door.

>open the door
You open the Front Door.

>enter the house
You can't see any such thing.

>n
Front Hall
You can see a Front Door here.

>n
Living Room

>s
Front Hall
You can see a Front Door here.

>w
Eli's Room

>w
You can't go that way.

>e
Front Hall
You can see a Front Door here.

>e
Utility Room

* * *

>enter the wagon
You get into the Station Wagon.

In the Station Wagon you can see a set of keys, Romulus, Remus and a little boy.

>open the wagon
It isn't something you can open.

>restart
Are you sure you want to restart?

>y
Cabin in The Woods
An Interactive Fiction by Noah Pivnick
Release 1 / Serial number 191015 / Inform 7 build 6M62 (I6/v6.33 lib 6/12N) SD

Driveway
You've arrived at the cabin after a grueling winter drive through a heavy winter storm. The snow is up to your knees and you are standing beside a battered station wagon. The station wagon's headlights are on casting their incandesent light onto a cabin floating above ground on posts driven deep into the ground.

You can see a Station Wagon (in which are a set of keys, Romulus, Remus and Eli) here.

* * *

>examine little boy
The little boy's name is Eli.

>x eli
The little boy's name is Eli.

>remove hat from eli
You can't see any such thing.

>showme
Driveway - room
    yourself - person
    Snow
    Station Wagon - open container
        set of keys
        Romulus - animal
        Remus - animal
        little boy

* * *

>examine station wagon
A section of thick, translucent, plastic drop cloth has been maticulously gaffer taped to the back gate where the rear window would normally be.

In the Station Wagon are a set of keys, Romulus, Remus and Eli.

* * *

>exit station
I only understood you as far as wanting to exit.

>exit wagon
I only understood you as far as wanting to exit.

>exit vehicle
I only understood you as far as wanting to exit.

* * *

>exit volvo
You get off the Station Wagon.

Driveway
You've arrived at the cabin after a grueling winter drive through a heavy winter storm. You are standing in the driveway up to your knees in deep, heavy wet snow. Beside you is a battered station wagon casting dim incandesent light from a single headlight onto a cabin floating above ground on square posts that have been driven deep into the earth. You are tired and terribly thirsty but there's a lot to do before you can open the house and turn on the water. It's well below freezing and the cabin will be very cold. You'll want to get a fire started as soon as possible.

You can see Snow and a Station Wagon (in which are a set of keys, Romulus, Remus and a little boy) here.

>enter volvo
You get into the Station Wagon.

In the Station Wagon you can see a set of keys, Romulus, Remus and a little boy.

>up
(first getting out of the Station Wagon)

Front Stairs
The Front Deck is nearly eight feet off the ground, accessible by a rise of ten steps made from 2x12 inch boards of unfinished pressure treated wood. A foot of snow has accumulated on each step. You know from experience there might very well be a slick of ice beneach the snow. Best to shift Eli's little body over your shoulder in a fireman's carry so you can hold onto the railing with one hand.

* * *

>go to utility room
You can't see any such thing.

>up
(first getting out of the Station Wagon)

Front Stairs
The Front Deck is nearly eight feet off the ground, accessible by a rise of ten steps made from 2x12 inch boards of unfinished pressure treated wood. A foot of snow has accumulated on each step. You know from experience there might very well be a slick of ice beneach the snow. Best to shift Eli's little body over your shoulder in a fireman's carry so you can hold onto the railing with one hand.

>u
Front Deck
You can see a Front Door here.

>u
You can't go that way.

>take all
There are none at all available!

>d
Front Stairs
The Front Deck is nearly eight feet off the ground, accessible by a rise of ten steps made from 2x12 inch boards of unfinished pressure treated wood. A foot of snow has accumulated on each step. You know from experience there might very well be a slick of ice beneach the snow. Best to shift Eli's little body over your shoulder in a fireman's carry so you can hold onto the railing with one hand.

>d
Driveway
You've arrived at the cabin after a grueling winter drive through a heavy winter storm. You are standing in the driveway up to your knees in deep, heavy wet snow. Beside you is a battered station wagon casting dim incandesent light from a single headlight onto a cabin floating above ground on square posts that have been driven deep into the earth. You are tired and terribly thirsty but there's a lot to do before you can open the house and turn on the water. It's well below freezing and the cabin will be very cold. You'll want to get a fire started as soon as possible.

You can see Snow and a Station Wagon (in which are a set of keys, Romulus, Remus and a little boy) here.

>d
You can't go that way.

>d
You can't go that way.

>take all
Snow: Taken.
Station Wagon: Taken.
set of keys: Taken.

>u
Front Stairs
The Front Deck is nearly eight feet off the ground, accessible by a rise of ten steps made from 2x12 inch boards of unfinished pressure treated wood. A foot of snow has accumulated on each step. You know from experience there might very well be a slick of ice beneach the snow. Best to shift Eli's little body over your shoulder in a fireman's carry so you can hold onto the railing with one hand.

>u
Front Deck
You can see a Front Door here.

* * *

>u
You can't go that way.

>uopen door
That's not a verb I recognise.

>unlock door
What do you want to unlock the Front Door with?

* * *

>unlock door with keys
You unlock the Front Door.

>n
(first opening the Front Door)

Front Hall
You can see a Front Door here.

>open door
That's already open.

>n
Living Room
You can see a Wood Burning Stove (empty) here.

>s
Front Hall
You can see a Front Door here.

>look
Front Hall
You can see a Front Door here.

>e
Utility Room
You can see a breaker box here.

>x beaker box
You can't see any such thing.

>x breaker
(the breaker box)
You see nothing special about the breaker box.

>w
Front Hall
You can see a Front Door here.

>n
Living Room
You can see a Wood Burning Stove (empty) here.

>look
Living Room
You can see a Wood Burning Stove (empty) here.

>x living room
You can't see any such thing.

* * *

>i
You are carrying nothing.

>open station wagon
It isn't something you can open.

>enter station wagon
You get into the station wagon.

In the station wagon you can see Romulus, Remus and Eli.

* * *

>look
foot of the driveway

>i
You are carrying nothing.

* * *

>n
You can't go that way.

>up
Driveway

* * *

>show me
What do you want to show yourself?

>showme
Driveway - room
    Snow
    Station Wagon - open container
        yourself - person
        set of keys
        Romulus - animal
        Remus - animal
        little boy - person

* * *

>take all
snow: Taken.

>open wagon
You open the station wagon, revealing a set of keys, Romulus, Remus and a little boy.

>take all
set of keys: Taken.

>u
Front Stairs
The Front Stairs are made from six foot lengths of 2 x 12 inch unfinished wood. A foot of snow has accumulated on each step. You know from experience there may very well be a slick of ice lurking beneath the snow.

>u
Front Deck
The Front Deck is nearly eight feet off the ground. There is no railing. A child might get hurt if they fell from this height.

You can see a Front Door here.

>u
You can't go that way.

>open door
It seems to be locked.

>unlock door with keys
You unlock the Front Door.

>n
It's cold outside. Best to bring the little boy from the car first.

>i
You are carrying:
  a set of keys
  snow

>eat snow'
You can't see any such thing.

>eat snow
You eat snow. Not bad.

>n
It's cold outside. Best to bring the little boy from the car first.

>purloin eli
[Purloined.]

>n
(first opening the Front Door)

Front Hall
The floor is sugar maple, as is most of the cabin interior. Sugar maple is a hardwood indigenous to the area, which makes it affordable. Eli's room is to the west. The Utility Room is to the East. To the North is the Living Room.

You can see a Front Door here.

>w
Eli's Room
It's sparse for a child's room. The interior is wainscoted with more sugar maple but Eli is a good boy, he would never write on the walls.

You can see a small mattress (empty) here.

>put eli in bed
You put the little boy into the small mattress.

>e
It's cold outside. Best to bring the little boy from the car first.

* * *

>u
Front Stairs
The Front Stairs are made from six foot lengths of 2 x 12 inch unfinished wood. A foot of snow has accumulated on each step. You know from experience there may very well be a slick of ice lurking beneath the snow.

>u
Front Deck
The Front Deck is nearly eight feet off the ground. There is no railing. A child could get hurt if they fell from this height.

You can see a Front Door here.

>u
You can't go that way.

>n
It's cold outside. Best to bring Eli from the car first.

>d
Front Stairs
The Front Stairs are made from lengths of 2 x 12 inch planks of unfinished wood. A foot of snow has accumulated on each step. You know from experience there may very well be a slick of ice lurking beneath the snow.

>d
Driveway
It's night. You've arrived at the cabin after a grueling drive through a heavy winter storm. You are standing in the driveway up to your knees in heavy wet snow. Beside you is a battered station wagon casting dim incandescent light from a single sad headlight onto a cabin floating above ground on square posts driven like pilings into the ground. You are exhausted and terribly thirsty but there's a lot to do before you can open the house and turn on the water. It's well below freezing. The cabin will be no less cold. You'll want to get a fire started as soon as possible.

You can see snow and a station wagon (closed) here.

>d
You can't go that way.

>take eli
You can't see any such thing.

>open wagon
You open the station wagon, revealing a set of keys, Romulus, Remus and a little boy.

>take eli
Taken.

>take keys
Taken.

>u
Front Stairs
The Front Stairs are made from lengths of 2 x 12 inch planks of unfinished wood. A foot of snow has accumulated on each step. You know from experience there may very well be a slick of ice lurking beneath the snow.

>u
Front Deck
The Front Deck is nearly eight feet off the ground. There is no railing. A child could get hurt if they went off the deck from this height.

You can see a Front Door here.

>u
You can't go that way.

>n
(first opening the Front Door)
It seems to be locked.

>unloack front door with keys
That's not a verb I recognise.

>unlock door with keys
You unlock the Front Door.

>n
(first opening the Front Door)

Front Hall
Most of the cabin interior is sugar maple, including the floor. Sugar Maple is a hardwood indigenous to the area, which makes it affordable. Eli's room is to the west. The Utility Room is to the East. To the North is the Living Room.

You can see a Front Door here.

>w
Eli's Room
The rooms in the cabin are wainscoted with more sugar maple.

You can see a bed (empty) here.

>put eli to bed
I didn't understand that sentence.

>put eli in bed
You put the little boy into the bed.

>e
It's cold outside. Best to bring Eli from the car first.

>e
It's cold outside. Best to bring Eli from the car first.

>undo
Eli's Room
[Previous turn undone.]

>i
You are carrying:
  a set of keys

>undo
Eli's Room
[Previous turn undone.]

>undo
Eli's Room
[Previous turn undone.]

>undo
Front Hall
[Previous turn undone.]

>e
Utility Room
You can see a breaker box here.

>w
Front Hall
Most of the cabin interior is sugar maple, including the floor. Sugar Maple is a hardwood indigenous to the area, which makes it affordable. Eli's room is to the west. The Utility Room is to the East. To the North is the Living Room.

You can see a Front Door here.

>n
Living Room
You can see a Wood Burning Stove (closed) and firewood here.

>x stove
A large, cast iron stove made by Vermont Castings. It's a good stove, probably the single most expensive item in the house.

>open stove
You open the Wood Burning Stove.

* * *

>n
It's cold outside. Best to bring Eli from the car first.

>purloin keys
[Purloined.]

>purloin eli
[Purloined.]

>open door
It seems to be locked.

* * *

>n
(first opening the Front Door)

Front Hall
Most of the cabin interior is sugar maple, including the floor. Sugar Maple is a hardwood indigenous to the area, which makes it affordable. Eli's room is to the west. The Utility Room is to the East. To the North is the Living Room.

You can see a Front Door here.

>n
Living Room
You can see a Wood Burning Stove (closed) and firewood here.

>s
Front Hall
Most of the cabin interior is sugar maple, including the floor. Sugar Maple is a hardwood indigenous to the area, which makes it affordable. Eli's room is to the west. The Utility Room is to the East. To the North is the Living Room.

You can see a Front Door here.

>w
Eli's Room
It's sparse for a child's room. The interior is wainscoted with more sugar maple, though Eli would never write on the walls. There's a small mattress on the floor.

You can see a bed (empty) here.

>put eli in bed
You put the little boy into the bed.

* * *

>up
Front Stairs
The Front Deck is nearly eight feet off the ground, accessible by a rise of ten steps made from 2x12 inch boards of weathered pressure treated wood. A foot of snow has accumulated on each step. You know from experience there might very well be a slick of ice beneach the snow. Best to shift Eli's little body over your shoulder in a fireman's carry so you can hold onto the railing with one hand.

* * *

>up
Front Deck
You can see a Front Door here.

>exit the station wagon
I only understood you as far as wanting to exit.

>leave the station wagon
I only understood you as far as wanting to leave.

>get out of the station wagon
I only understood you as far as wanting to get outside.

* * *

>open door
It seems to be locked.

>x door
The Front Door is heavy and slides to one side like a barn door. This was a financial decision. Regular doors on hinges are expensive and need to be hung properly. The door has a large window but the window is boarded up from the inside with a piece of plywood.

>unlock the door
(with the Front Door)
(first taking the Front Door)
That's fixed in place.

>open the door
It seems to be locked.

>down
Front Stairs
The Front Deck is nearly eight feet off the ground, accessible by a rise of ten steps made from 2x12 inch boards of weathered pressure treated wood. A foot of snow has accumulated on each step. You know from experience there might very well be a slick of ice beneach the snow. Best to shift Eli's little body over your shoulder in a fireman's carry so you can hold onto the railing with one hand.

>down
Driveway
You've arrived at the cabin after a grueling winter drive through a heavy winter storm. You are standing in the driveway up to your knees in deep, heavy wet snow. Beside you is a battered station wagon casting dim incandesent light from a single headlight onto a cabin floating above ground on square posts that have been driven deep into the earth. You are tired and terribly thirsty from the drive but there's a lot to do before you can open the house and turn on the water. It's well below freezing and the cabin will be very cold. You'll want to get a fire started as soon as possible.

You can see Snow and a Station Wagon (in which are a set of keys in the ignition, Romulus, Remus and a little boy) here.

>enter the wagon
You get into the Station Wagon.

In the Station Wagon you can see a set of keys in the ignition, Romulus, Remus and a little boy.

>x the wagon
A mid-80"s Volvo 240 that's seen better days. A section of thick, translucent, plastic drop cloth has been maticulously gaffer taped to the back gate where the rear window would normally be. The front of car on the passenger side is pretty well bashed in. Only the drivers side headlight appears to be working. There's steam rising from underneath the crumpled hood.

In the Station Wagon are a set of keys in the ignition, Romulus, Remus and a little boy.

>take keys
Taken.

>up
(first getting out of the Station Wagon)

Front Stairs
The Front Deck is nearly eight feet off the ground, accessible by a rise of ten steps made from 2x12 inch boards of weathered pressure treated wood. A foot of snow has accumulated on each step. You know from experience there might very well be a slick of ice beneach the snow. Best to shift Eli's little body over your shoulder in a fireman's carry so you can hold onto the railing with one hand.

>up
Front Deck
You can see a Front Door here.

>open
(the set of keys in the ignition)
It isn't something you can open.

* * *

>up
You can't go that way.

>down
front stairs

>n
You can't go that way.

>down
Driveway
You can see the station wagon (in which are Romulus, Remus and Eli) here.

>look
Driveway
You can see the station wagon (in which are Romulus, Remus and Eli) here.

* * *

>x Remus
A big dog. Half Belgian Shepard, half Newfoundland. Romulus and Remus came from the same litter.

>x Remus
A big dog. Half Belgian Shepard, half Newfoundland. Romulus and Remus came from the same litter.

>x eli
The little boy is asleep in the back seat. His name is Eli. He's almost seven years old and he's wearing a secondhand snowsuit that's few sizes too big for him. Eli is not your child but you are his mom. It's complicated.

>x Romulus
A big dog. Half Belgian Shepard, half Newfoundland. Romulus and Remus came from the same litter.

>x remus
A big dog. Half Belgian Shepard, half Newfoundland. Romulus and Remus came from the same litter.

>exit the wagon
You get off the Station Wagon.

Driveway
You've arrived at the cabin after a grueling winter drive through a heavy winter storm. You are standing in the driveway up to your knees in deep, heavy wet snow. Beside you is a battered station wagon casting dim incandesent light from a single headlight onto a cabin floating above ground on square posts that have been driven deep into the earth. You are tired and terribly thirsty but there's a lot to do before you can open the house and turn on the water. It's well below freezing and the cabin will be very cold. You'll want to get a fire started as soon as possible.

You can see Snow and a Station Wagon (in which are a set of keys, Romulus, Remus and a little boy) here.

* * *

>x eli
The little boy is asleep in the back seat. He's wearing a snowsuit that's too big for him. His name is Eli and he's is seven years old. Eli is not your child but you are his mom. It's complicated.

>carry eli
Taken.

>up
Front Stairs

* * *

>x fred
You see nothing special about Fred.

>take fred
I don't suppose Fred would care for that.

>carry fred
I don't suppose Fred would care for that.

>x fred
You see nothing special about Fred.

>x fred
You see nothing special about Fred.

>showme
Driveway - room
    yourself - person
    Snow
    Station Wagon - open container
        Fred - person
            snow suit (worn)
        set of keys
        Romulus - animal
        Remus - animal
        little boy

* * *

>x remus
A big dog. Half Belgian Shepard, half Newfoundland, and black as night. Romulus and Remus came from the same litter.

* * *

>x romulus
A big dog. Half Belgian Shepard, half Newfoundland, and black as night. Romulus and Remus came from the same litter.

>x little boy
The little boy is asleep in the back seat. His name is Eli. He's almost seven years old and he's wearing a secondhand snowsuit that's few sizes too big for him. Eli is not your child but you are his mom. It's complicated.

>x keys
You see nothing special about the set of keys.

>take all
Snow: Taken.
set of keys: Taken.

>take eli
Taken.

>up
Front Stairs
The Front Stairs are made from lengths of 2 x 12 inch planks of unfinished wood. A foot of snow has accumulated on each step. You know from experience there might very well be a slick of ice beneath the snow. Best to shift Eli's little body over your shoulder in a fireman's carry so you can hold onto the railing with one hand.

>up
Front Deck
The Front Deck is nearly eight feet off the ground. There is no railing. A child could get hurt if they went off the deck from this height.

You can see a Front Door here.

* * *

>up
You can't go that way.

>n
(first opening the Front Door)
It seems to be locked.

>unlock the door with the keys
You unlock the Front Door.

>open the door
You open the Front Door.

>x front door
The Front Door is heavy and slides to one side like a barn door. This was a cost saving decision. Doors on hinges are expensive -- especially exterior doors -- and need to be hung precisely. The door has a large window but the window is boarded up from the inside with a piece of plywood to keep out prying eyes.

>n
Front Hall
Most of the cabin interior is built with sugar maple, including the floor. Sugar Maple is a hardwood indigenous to the area, which makes it affordable.

You can see a Front Door here.

* * *

>n
Living Room
You can see a Wood Burning Stove (closed) and firewood here.

>x wood
A large, cast iron stove made by Vermont Castings. It's a good stove, probably the single most expensive item in the house.

>take fire
You can't see any such thing.

>take firewood
Taken.

>open stove
You open the Wood Burning Stove.

>x stove
A large, cast iron stove made by Vermont Castings. It's a good stove, probably the single most expensive item in the house.

>open stove
That's already open.

>x stove
A large, cast iron stove made by Vermont Castings. It's a good stove, probably the single most expensive item in the house.

* * *

>open stove
That's already open.

>put firewood in stove
You put firewood into the Wood Burning Stove.

>take maches
You can't see any such thing.

>take matches
You can't see any such thing.

>light firewood with matches
I only understood you as far as wanting to light firewood.

* * *

>x snow
You see nothing special about snow.

>x station wagon
A mid-80"s Volvo 240 that's seen better days. The back gate is covered with a section of thick, translucent, plastic drop cloth and gaffers tape where the rear window would normally be. The front of the car on the passenger side is pretty well bashed in. Only the driver side headlight appears to be working. There's steam rising from underneath the crumpled hood.

>look wagon
A mid-80"s Volvo 240 that's seen better days. The back gate is covered with a section of thick, translucent, plastic drop cloth and gaffers tape where the rear window would normally be. The front of the car on the passenger side is pretty well bashed in. Only the driver side headlight appears to be working. There's steam rising from underneath the crumpled hood.

>up
Front Stairs
The Front Stairs are made from lengths of 2 x 12 inch planks of unfinished wood. A foot of snow has accumulated on each step. You know from experience there may very well be a slick of ice lurking beneath the snow.

>up
Front Deck
The Front Deck is nearly eight feet off the ground. There is no railing. A child could get hurt if they went off the deck from this height.

You can see a Front Door here.

>n
It's cold outside. Best to bring Eli from the car first.

>open door
It seems to be locked.

>open door
It seems to be locked.

>unlock door
(with the Front Door)
(first taking the Front Door)
That's fixed in place.

>n
It's cold outside. Best to bring Eli from the car first.

* * *

>open door
It seems to be locked.

>d
Front Stairs
The Front Stairs are made from lengths of 2 x 12 inch planks of unfinished wood. A foot of snow has accumulated on each step. You know from experience there may very well be a slick of ice lurking beneath the snow.

* * *

>open wagon
You open the station wagon, revealing a set of keys, Romulus, Remus and a little boy.

>x keys
You see nothing special about the set of keys.

>x remus
A big dog. Half Belgian Shepard, half Newfoundland, and black as night. Romulus and Remus came from the same litter.

* * *

>x romulus
A big dog. Half Belgian Shepard, half Newfoundland, and black as night. Romulus and Remus came from the same litter.

>x little boy
The little boy is asleep in the back seat. His name is Eli. He's nearly six years old and wearing a secondhand snowsuit that's still few sizes too big. Eli is not your child but you are his mom. It's complicated.

>carry eli
Taken.

>take keys
Taken.

* * *

I beg your pardon?

I beg your pardon?

>enter wagon
You get into the station wagon.

In the station wagon you can see Romulus and Remus.

>up
(first getting out of the station wagon)

Front Stairs
The Front Stairs are made from lengths of 2 x 12 inch planks of unfinished wood. A foot of snow has accumulated on each step. You know from experience there may very well be a slick of ice lurking beneath the snow.

>up
Front Deck
The Front Deck is nearly eight feet off the ground. There is no railing. A child could get hurt if they went off the deck from this height.

You can see a Front Door here.

* * *

>n
(first opening the Front Door)
It seems to be locked.

>x door
The Front Door is heavy and slides to one side like a barn door. This was a cost saving decision. Doors on hinges are expensive -- especially exterior doors -- and need to be hung precisely. The door has a large window but the window is boarded up from the inside with a piece of plywood to keep out prying eyes.

>look
Front Deck
The Front Deck is nearly eight feet off the ground. There is no railing. A child could get hurt if they went off the deck from this height.

You can see a Front Door here.

>n
(first opening the Front Door)
It seems to be locked.

>unlock door
What do you want to unlock the Front Door with?

* * *

>enter
You must supply a noun.

>enter front hall
I only understood you as far as wanting to enter the Front Door.

>n
(first opening the Front Door)

Front Hall
Most of the cabin interior is sugar maple, including the floor. Sugar Maple is a hardwood indigenous to the area, which makes it affordable. Eli's room is to the west. The Utility Room is to the East. To the North is the Living Room.

You can see a Front Door here.

>look
Front Hall
Most of the cabin interior is sugar maple, including the floor. Sugar Maple is a hardwood indigenous to the area, which makes it affordable. Eli's room is to the west. The Utility Room is to the East. To the North is the Living Room.

You can see a Front Door here.

>e
Utility Room
You can see a breaker box here.

* * *

>w
Front Hall
Most of the cabin interior is sugar maple, including the floor. Sugar Maple is a hardwood indigenous to the area, which makes it affordable. Eli's room is to the west. The Utility Room is to the East. To the North is the Living Room.

You can see a Front Door here.

>w
Eli's Room
The rooms in the cabin are wainscoted with more sugar maple.

You can see a bed (empty) here.

>put eli in bed
You put the little boy into the bed.

>w
You can't go that way.

>e
It's cold outside. Best to bring Eli from the car first.

>n
You can't go that way.

>e
It's cold outside. Best to bring Eli from the car first.

>look
Eli's Room
The rooms in the cabin are wainscoted with more sugar maple.

You can see a bed (in which is a little boy) here.

>e
It's cold outside. Best to bring Eli from the car first.

* * *

>n
You can't go that way.

>w
You can't go that way.

>w
You can't go that way.

* * *

>e
It's cold outside. Best to bring Eli from the car first.

>w
You can't go that way.

>look
Eli's Room
The rooms in the cabin are wainscoted with more sugar maple.

You can see a bed (in which is a little boy) here.

* * *

>x the little boy
The little boy's name is Eli.